Date,Stock Price (USD),Revenue (Million USD),Expenses (Million USD),Net Profit (Million USD),Volume Traded
2024-01-01,150,50,30,20,1000000
2024-01-02,152,52,31,21,1100000
2024-01-03,148,49,29,20,1050000
2024-01-04,155,55,32,23,1200000
2024-01-05,157,58,34,24,1250000
2024-01-06,160,60,35,25,1300000
2024-01-07,158,59,33,26,1280000
2024-01-08,162,62,36,26,1350000
2024-01-09,165,65,38,27,1400000
2024-01-10,163,63,37,26,1380000
